message_type_code	message_type_name
PUBLIC_SYSTEM	公開システムメッセージ
PRIVATE_SYSTEM	非公開システムメッセージ
PRIVATE_SEER	白黒占い結果
PRIVATE_WISE	役職占い結果
PRIVATE_PSYCHIC	白黒霊視結果
PRIVATE_GURU	役職霊視結果
PRIVATE_WEREWOLF	襲撃結果
PRIVATE_FANATIC	狂信者人狼確認メッセージ
PRIVATE_MASON	共有相互確認メッセージ
PRIVATE_SYMPATHIZER	共鳴相互確認メッセージ
PRIVATE_CORONER	検死結果
NORMAL_SAY	通常発言
MONOLOGUE_SAY	独り言
GRAVE_SAY	死者の呻き
WEREWOLF_SAY	人狼の囁き
SYMPATHIZE_SAY	共鳴発言
SPECTATE_SAY	見学発言
CREATOR_SAY	村建て発言
SECRET_SAY	秘話
PARTICIPANTS	参加者一覧
